accessorize	accessorize
accessorized	accessorized
accessorizes	accessorizes
accessorizing	accessorizing
acclimatization	acclimatization
acclimatize	acclimatize
acclimatized	acclimatized
acclimatizes	acclimatizes
acclimatizing	acclimatizing
accoutrements	accouterments
aeon	eon
aeons	eons
aerogramme	aerogram
aerogrammes	aerograms
aeroplane	airplane
aeroplanes	airplanes
aesthete	esthete
aesthetes	esthetes
aesthetic	esthetic
aesthetically	esthetically
aesthetics	esthetics
aetiology	etiology
aggrandisement	aggrandizement
agonize	agonize
agonized	agonized
agonizes	agonizes
agonizing	agonizing
agonizingly	agonizingly
almanack	almanac
almanacks	almanacs
aluminium	aluminum
amortizable	amortizable
amortization	amortization
amortizations	amortizations
amortize	amortize
amortized	amortized
amortizes	amortizes
amortizing	amortizing
amphitheatre	amphitheater
amphitheatres	amphitheaters
anaemia	anemia
anaemic	anemic
anaesthesia	anesthesia
anaesthetic	anesthetic
anaesthetics	anesthetics
anaesthetize	anesthetize
anaesthetized	anesthetized
anaesthetizes	anesthetizes
anaesthetizing	anesthetizing
anaesthetist	anesthesiologist
anaesthetist	anesthetist
anaesthetists	anesthetists
anaesthetize	anesthetize
anaesthetized	anesthetized
anaesthetizes	anesthetizes
anaesthetizing	anesthetizing
analogue	analog
analogues	analogs
analyse	analyze
analysed	analyzed
analyser	analyzer
analyses	analyzes
analysing	analyzing
anglicize	anglicize
anglicized	anglicized
anglicizes	anglicizes
anglicizing	anglicizing
annualized	annualized
antagonize	antagonize
antagonized	antagonized
antagonizes	antagonizes
antagonizing	antagonizing
antennae	antennas
anti-aliased	antialiased
anti-aliasing	antialiasing
anti-clockwize	counter-clockwise
anti-clockwize	counterclockwise
any more	anymore
apologize	apologize
apologized	apologized
apologizes	apologizes
apologizing	apologizing
appal	appall
appals	appalls
appetizer	appetizer
appetizers	appetizers
appetizing	appetizing
appetizingly	appetizingly
arbour	arbor
arbours	arbors
archaeological	archeological
archaeologically	archeologically
archaeologist	archeologist
archaeologists	archeologists
archaeology	archeology
ardour	ardor
armour	armor
armoured	armored
armourer	armorer
armourers	armorers
armouries	armories
armoury	armory
artefact	artifact
artefacts	artifacts
authorization	authorization
authorizational	authorizational
authorize	authorize
authorized	authorized
authorizes	authorizes
authorizing	authorizing
backpedalled	backpedaled
backpedalling	backpedaling
bannister	banister
bannisters	banisters
baptize	baptize
baptized	baptized
baptizes	baptizes
baptizing	baptizing
bastardize	bastardize
bastardized	bastardized
bastardizes	bastardizes
bastardizing	bastardizing
battleaxe	battleax
baulk	balk
baulked	balked
baulking	balking
baulks	balks
bedevilled	bedeviled
bedevilling	bedeviling
behaviour	behavior
behavioural	behavioral
behaviourism	behaviorism
behaviourist	behaviorist
behaviourists	behaviorists
behaviours	behaviors
behove	behoove
behoved	behooved
behoves	behooves
bejewelled	bejeweled
belabour	belabor
belaboured	belabored
belabouring	belaboring
belabours	belabors
bevelled	beveled
bevvies	bevies
bevvy	bevy
bingeing	binging
bougainvillaea	bougainvillea
bougainvillaeas	bougainvilleas
bowdlerize	bowdlerize
bowdlerized	bowdlerized
bowdlerizes	bowdlerizes
bowdlerizing	bowdlerizing
breathalyse	breathalyze
breathalysed	breathalyzed
breathalyser	breathalyzer
breathalysers	breathalyzers
breathalyses	breathalyzes
breathalysing	breathalyzing
brutalize	brutalize
brutalized	brutalized
brutalizes	brutalizes
brutalizing	brutalizing
buses	busses
busing	bussing
caesarean	cesarean
caesareans	cesareans
calibre	caliber
calibres	calibers
calliper	caliper
callipers	calipers
callisthenics	calisthenics
canalize	canalize
canalized	canalized
canalizes	canalizes
canalizing	canalizing
cancellation	cancelation
cancellations	cancelations
cancelled	canceled
cancelling	canceling
candour	candor
cannibalize	cannibalize
cannibalized	cannibalized
cannibalizes	cannibalizes
cannibalizing	cannibalizing
canonize	canonize
canonized	canonized
canonizes	canonizes
canonizing	canonizing
capitalization	capitalization
capitalize	capitalize
capitalized	capitalized
capitalizes	capitalizes
capitalizing	capitalizing
car park	parking lot
caramelize	caramelize
caramelized	caramelized
caramelizes	caramelizes
caramelizing	caramelizing
carbonize	carbonize
carbonized	carbonized
carbonizes	carbonizes
carbonizing	carbonizing
carolled	caroled
carolling	caroling
case-insensitive	case insensitive
case-sensitive	case sensitive
catalogue	catalog
catalogue 	catalog
catalogue.	catalog.
catalogued	cataloged
catalogues	catalogs
cataloguing	cataloging
catalyse	catalyze
catalysed	catalyzed
catalyses	catalyzes
catalysing	catalyzing
categorization	categorization
categorize	categorize
categorized	categorized
categorizes	categorizes
categorizing	categorizing
cauterize	cauterize
cauterized	cauterized
cauterizes	cauterizes
cauterizing	cauterizing
cavilled	caviled
cavilling	caviling
centigramme	centigram
centigrammes	centigrams
centilitre	centiliter
centilitres	centiliters
centimetre	centimeter
centimetres	centimeters
centralization	centralization
centralize	centralize
centralized	centralized
centralizes	centralizes
centralizing	centralizing
centre	center
centred	centered
centrefold	centerfold
centrefolds	centerfolds
centrepiece	centerpiece
centrepieces	centerpieces
centres	centers
centring	centering
channelled	channeled
channelling	channeling
characterize	characterize
characterized	characterized
characterizes	characterizes
characterizing	characterizing
charivari	shivaree
chequebook	checkbook
chequebooks	checkbooks
chequer	checker
chequerboard	checkerboard
chequered	checkered
cheques	checks
chilli	chili
chimaera	chimera
chimaeras	chimeras
chiselled	chiseled
chiselling	chiseling
circularize	circularize
circularized	circularized
circularizes	circularizes
circularizing	circularizing
civilize	civilize
civilized	civilized
civilizes	civilizes
civilizing	civilizing
clamour	clamor
clamoured	clamored
clamouring	clamoring
clamours	clamors
clangour	clangor
clarinettist	clarinetist
clarinettists	clarinetists
co-operate	cooperate
co-ordinate	coordinate
collectivize	collectivize
collectivized	collectivized
collectivizes	collectivizes
collectivizing	collectivizing
colonization	colonization
colonize	colonize
colonized	colonized
colonizer	colonizer
colonizers	colonizers
colonizes	colonizes
colonizing	colonizing
colour	color
colour-key	colorkey
colour-space	colorspace
colourant	colorant
colourants	colorants
coloured	colored
coloureds	coloreds
colourer	colorer
colourful	colorful
colourfully	colorfully
colouring	coloring
colourize	colorize
colourized	colorized
colourizes	colorizes
colourizing	colorizing
colourless	colorless
colours	colors
commercialize	commercialize
commercialized	commercialized
commercializes	commercializes
commercializing	commercializing
compartmentalize	compartmentalize
compartmentalized	compartmentalized
compartmentalizes	compartmentalizes
compartmentalizing	compartmentalizing
computerize	computerize
computerized	computerized
computerizes	computerizes
computerizing	computerizing
conceptualize	conceptualize
conceptualized	conceptualized
conceptualizes	conceptualizes
conceptualizing	conceptualizing
connexion	connection
connexions	connections
contextualize	contextualize
contextualized	contextualized
contextualizes	contextualizes
contextualizing	contextualizing
cosier	cozier
cosies	cozies
cosiest	coziest
cosily	cozily
cosiness	coziness
cosy	cozy
councillor	councilor
councillors	councilors
counselled	counseled
counselling	counseling
counsellor	counselor
counsellors	counselors
coup√©	coupe
crenellated	crenelated
criminalize	criminalize
criminalized	criminalized
criminalizes	criminalizes
criminalizing	criminalizing
criticize	criticize
criticized	criticized
criticizes	criticizes
criticizing	criticizing
crueller	crueler
cruellest	cruelest
crystallization	crystallization
crystallize	crystallize
crystallized	crystallized
crystallizes	crystallizes
crystallizing	crystallizing
cudgelled	cudgeled
cudgelling	cudgeling
curricula	curriculums
customizable	customizable
customization	customization
customize	customize
customized	customized
customizes	customizes
customizing	customizing
cypher	cipher
cyphers	ciphers
dealt	dealed
decentralization	decentralization
decentralize	decentralize
decentralized	decentralized
decentralizes	decentralizes
decentralizing	decentralizing
decriminalization	decriminalization
decriminalize	decriminalize
decriminalized	decriminalized
decriminalizes	decriminalizes
decriminalizing	decriminalizing
defence	defense
defenceless	defenseless
defences	defenses
dehumanization	dehumanization
dehumanize	dehumanize
dehumanized	dehumanized
dehumanizes	dehumanizes
dehumanizing	dehumanizing
demeanour	demeanor
demilitarization	demilitarization
demilitarize	demilitarize
demilitarized	demilitarized
demilitarizes	demilitarizes
demilitarizing	demilitarizing
demobilization	demobilization
demobilize	demobilize
demobilized	demobilized
demobilizes	demobilizes
demobilizing	demobilizing
democratization	democratization
democratize	democratize
democratized	democratized
democratizes	democratizes
democratizing	democratizing
demonize	demonize
demonized	demonized
demonizes	demonizes
demonizing	demonizing
demoralization	demoralization
demoralize	demoralize
demoralized	demoralized
demoralizes	demoralizes
demoralizing	demoralizing
denationalization	denationalization
denationalize	denationalize
denationalized	denationalized
denationalizes	denationalizes
denationalizing	denationalizing
deodorize	deodorize
deodorized	deodorized
deodorizes	deodorizes
deodorizing	deodorizing
depersonalize	depersonalize
depersonalized	depersonalized
depersonalizes	depersonalizes
depersonalizing	depersonalizing
deputize	deputize
deputized	deputized
deputizes	deputizes
deputizing	deputizing
desensitization	desensitization
desensitize	desensitize
desensitized	desensitized
desensitizes	desensitizes
desensitizing	desensitizing
destabilization	destabilization
destabilize	destabilize
destabilized	destabilized
destabilizes	destabilizes
destabilizing	destabilizing
dialled	dialed
dialler	dialer
dialling	dialing
dialogue	dialog
dialogues	dialogs
diarrhoea	diarrhea
digitization	digitization
digitize	digitize
digitized	digitized
digitizer	digitizer
digitizes	digitizes
digitizing	digitizing
disc 	disk
disc-	disk-
disc,	disk,
disc;	disk;
disc.	disk.
discolour	discolor
discoloured	discolored
discolouring	discoloring
discolours	discolors
discs	disks
discy	disky
disembowelled	disemboweled
disembowelling	disemboweling
disfavour	disfavor
dishevelled	disheveled
dishonour	dishonor
dishonourable	dishonorable
dishonourably	dishonorably
dishonoured	dishonored
dishonouring	dishonoring
dishonours	dishonors
disorganization	disorganization
disorganized	disorganized
distil	distill
distils	distills
doughnut	donut
dramatization	dramatization
dramatizations	dramatizations
dramatize	dramatize
dramatized	dramatized
dramatizes	dramatizes
dramatizing	dramatizing
draught	draft
draughtboard	draftboard
draughtboards	draftboards
draughtier	draftier
draughtiest	draftiest
draughts	drafts
draughtsman	draftsman
draughtsmanship	draftsmanship
draughtsmen	draftsmen
draughtswoman	draftswoman
draughtswomen	draftswomen
draughty	drafty
dreamt	dreamed
drivelled	driveled
drivelling	driveling
duelled	dueled
duelling	dueling
economize	economize
economized	economized
economizes	economizes
economizing	economizing
editorialize	editorialize
editorialized	editorialized
editorializes	editorializes
editorializing	editorializing
edoema	edema
empathize	empathize
empathized	empathized
empathizes	empathizes
empathizing	empathizing
emphasize	emphasize
emphasized	emphasized
emphasizes	emphasizes
emphasizing	emphasizing
enamelled	enameled
enamelling	enameling
enamoured	enamored
encyclopaedia	encyclopedia
encyclopaedias	encyclopedias
encyclopaedic	encyclopedic
endeavour	endeavor
endeavoured	endeavored
endeavouring	endeavoring
endeavours	endeavors
energize	energize
energized	energized
energizes	energizes
energizing	energizing
enrol	enroll
enrols	enrolls
enthral	enthrall
enthrals	enthralls
epaulette	epaulet
epaulettes	epaulets
epicentre	epicenter
epicentres	epicenters
epilogue	epilog
epilogues	epilogs
epitomize	epitomize
epitomized	epitomized
epitomizes	epitomizes
epitomizing	epitomizing
equalization	equalization
equalize	equalize
equalized	equalized
equalizer	equalizer
equalizers	equalizers
equalizes	equalizes
equalizing	equalizing
equalled	equaled
equalling	equaling
eulogize	eulogize
eulogized	eulogized
eulogizes	eulogizes
eulogizing	eulogizing
evangelize	evangelize
evangelized	evangelized
evangelizes	evangelizes
evangelizing	evangelizing
exorcize	exorcize
exorcized	exorcized
exorcizes	exorcizes
exorcizing	exorcizing
extemporization	extemporization
extemporize	extemporize
extemporized	extemporized
extemporizes	extemporizes
extemporizing	extemporizing
externalization	externalization
externalizations	externalizations
externalize	externalize
externalized	externalized
externalizes	externalizes
externalizing	externalizing
factorize	factorize
factorized	factorized
factorizes	factorizes
factorizing	factorizing
faecal	fecal
faeces	feces
familiarization	familiarization
familiarize	familiarize
familiarized	familiarized
familiarizes	familiarizes
familiarizing	familiarizing
fantasize	fantasize
fantasized	fantasized
fantasizes	fantasizes
fantasizing	fantasizing
favour	favor
favourable	favorable
favourably	favorably
favoured	favored
favouring	favoring
favourite	favorite
favourites	favorites
favouritism	favoritism
favours	favors
feminize	feminize
feminized	feminized
feminizes	feminizes
feminizing	feminizing
fertilization	fertilization
fertilize	fertilize
fertilized	fertilized
fertilizer	fertilizer
fertilizers	fertilizers
fertilizes	fertilizes
fertilizing	fertilizing
fervour	fervor
fibre	fiber
fibreglass	fiberglass
fibres	fibers
fictionalization	fictionalization
fictionalizations	fictionalizations
fictionalize	fictionalize
fictionalized	fictionalized
fictionalizes	fictionalizes
fictionalizing	fictionalizing
fillet	filet
filleted	fileted
filleting	fileting
fillets	filets
film	movie
finalization	finalization
finalize	finalize
finalized	finalized
finalizes	finalizes
finalizing	finalizing
flautist	flutist
flautists	flutists
flavour	flavor
flavoured	flavored
flavouring	flavoring
flavourings	flavorings
flavourless	flavorless
flavours	flavors
flavoursome	flavorsome
flyer/flier	flier/flyer
foetal	fetal
foetid	fetid
foetus	fetus
foetuses	fetuses
formalization	formalization
formalize	formalize
formalized	formalized
formalizes	formalizes
formalizing	formalizing
formulae	formulas
forthcoming	upcoming
fossilization	fossilization
fossilize	fossilize
fossilized	fossilized
fossilizes	fossilizes
fossilizing	fossilizing
fraternization	fraternization
fraternize	fraternize
fraternized	fraternized
fraternizes	fraternizes
fraternizing	fraternizing
fuelled	fueled
fuelling	fueling
fulfil	fulfill
fulfilment	fulfillment
fulfils	fulfills
funnelled	funneled
funnelling	funneling
furore	furor
galvanize	galvanize
galvanized	galvanized
galvanizes	galvanizes
galvanizing	galvanizing
gambolled	gamboled
gambolling	gamboling
gaol	jail
gaolbird	jailbird
gaolbirds	jailbirds
gaolbreak	jailbreak
gaolbreaks	jailbreaks
gaoled	jailed
gaoler	jailer
gaolers	jailers
gaoling	jailing
gaols	jails
gases	gasses
generalization	generalization
generalizations	generalizations
generalize	generalize
generalized	generalized
generalizes	generalizes
generalizing	generalizing
ghettoize	ghettoize
ghettoized	ghettoized
ghettoizes	ghettoizes
ghettoizing	ghettoizing
gipsies	gypsies
glamorize	glamorize
glamorized	glamorized
glamorizes	glamorizes
glamorizing	glamorizing
glamour	glamor
globalization	globalization
globalizational	globalizational
globalize	globalize
globalized	globalized
globalizes	globalizes
globalizing	globalizing
globally	globaly
glueing	gluing
glycerine	glycerin
goitre	goiter
goitres	goiters
gonorrhoea	gonorrhea
gravelled	graveled
grey	gray
greyed	grayed
greying	graying
greyish	grayish
greylist	graylist
greylisted	graylisted
greylisting	graylisting
greyness	grayness
greys	grays
grovelled	groveled
grovelling	groveling
groyne	groin
groynes	groins
gruelling	grueling
gruellingly	gruelingly
gryphon	griffin
gryphons	griffins
guerrilla	guerilla
gynaecological	gynecological
gynaecologist	gynecologist
gynaecologists	gynecologists
gynaecology	gynecology
haematological	hematological
haematologist	hematologist
haematologists	hematologists
haematology	hematology
haemoglobin	hemoglobin
haemophilia	hemophilia
haemophiliac	hemophiliac
haemophiliacs	hemophiliacs
haemorrhage	hemorrhage
haemorrhaged	hemorrhaged
haemorrhages	hemorrhages
haemorrhaging	hemorrhaging
haemorrhoids	hemorrhoids
harbour	harbor
harboured	harbored
harbouring	harboring
harbours	harbors
harmonization	harmonization
harmonize	harmonize
harmonized	harmonized
harmonizes	harmonizes
harmonizing	harmonizing
haulier	hauler
homoeopath	homeopath
homoeopathic	homeopathic
homoeopaths	homeopaths
homoeopathy	homeopathy
homogenize	homogenize
homogenized	homogenized
homogenizes	homogenizes
homogenizing	homogenizing
honour	honor
honourable	honorable
honourably	honorably
honoured	honored
honouring	honoring
honours	honors
hospitalization	hospitalization
hospitalize	hospitalize
hospitalized	hospitalized
hospitalizes	hospitalizes
hospitalizing	hospitalizing
humanize	humanize
humanized	humanized
humanizes	humanizes
humanizing	humanizing
humour	humor
humoured	humored
humouring	humoring
humourless	humorless
humours	humors
hybridize	hybridize
hybridized	hybridized
hybridizes	hybridizes
hybridizing	hybridizing
hypnotize	hypnotize
hypnotized	hypnotized
hypnotizes	hypnotizes
hypnotizing	hypnotizing
hypothesize	hypothesize
hypothesized	hypothesized
hypothesizes	hypothesizes
hypothesizing	hypothesizing
idealization	idealization
idealize	idealize
idealized	idealized
idealizes	idealizes
idealizing	idealizing
idolize	idolize
idolized	idolized
idolizes	idolizes
idolizing	idolizing
immobilization	immobilization
immobilize	immobilize
immobilized	immobilized
immobilizer	immobilizer
immobilizers	immobilizers
immobilizes	immobilizes
immobilizing	immobilizing
immortalize	immortalize
immortalized	immortalized
immortalizes	immortalizes
immortalizing	immortalizing
immunization	immunization
immunize	immunize
immunized	immunized
immunizes	immunizes
immunizing	immunizing
impanelled	impaneled
impanelling	impaneling
imperilled	imperiled
imperilling	imperiling
individualize	individualize
individualized	individualized
individualizes	individualizes
individualizing	individualizing
industrialize	industrialize
industrialized	industrialized
industrializes	industrializes
industrializing	industrializing
inflexion	inflection
inflexions	inflections
initialization	initialization
initializational	initializational
initialize	initialize
initialized	initialized
initializer	initializer
initializes	initializes
initializing	initializing
initialled	initialed
initialling	initialing
instal	install
instalment	installment
instalments	installments
instals	installs
instil	instill
instils	instills
institutionalization	institutionalization
institutionalize	institutionalize
institutionalized	institutionalized
institutionalizes	institutionalizes
institutionalizing	institutionalizing
intellectualize	intellectualize
intellectualized	intellectualized
intellectualizes	intellectualizes
intellectualizing	intellectualizing
internalization	internalization
internalize	internalize
internalized	internalized
internalizes	internalizes
internalizing	internalizing
internationalization	internationalization
internationalizational	internationalizational
internationalize	internationalize
internationalized	internationalized
internationalizes	internationalizes
internationalizing	internationalizing
ionization	ionization
ionize	ionize
ionized	ionized
ionizer	ionizer
ionizers	ionizers
ionizes	ionizes
ionizing	ionizing
italicize	italicize
italicized	italicized
italicizes	italicizes
italicizing	italicizing
itemized	itemized
itemizes	itemizes
itemizing	itemizing
jeopardize	jeopardize
jeopardized	jeopardized
jeopardizes	jeopardizes
jeopardizing	jeopardizing
jewelled	jeweled
jeweller	jeweler
jewellers	jewelers
jewellery	jewelery
jewellery	jewelry
journalling	journaling
judgement	judgment
kilogramme	kilogram
kilogrammes	kilograms
kilometre	kilometer
kilometres	kilometers
knelt	kneeled
labelled	labeled
labeller	labeler
labelling	labeling
labour	labor
laboured	labored
labourer	laborer
labourers	laborers
labouring	laboring
labours	labors
lacklustre	lackluster
ladybird	ladybug
learnt	learned
legalization	legalization
legalize	legalize
legalized	legalized
legalizes	legalizes
legalizing	legalizing
legitimize	legitimize
legitimized	legitimized
legitimizes	legitimizes
legitimizing	legitimizing
lept	leaped
letterbox	mailbox
leukaemia	leukemia
levelled	leveled
leveller	leveler
levellers	levelers
levelling	leveling
libelled	libeled
libelling	libeling
libellous	libelous
liberalization	liberalization
liberalize	liberalize
liberalized	liberalized
liberalizes	liberalizes
liberalizing	liberalizing
licence	license
licenced	licensed
licences	licenses
licencing	licensing
likeable	likable
lionization	lionization
lionize	lionize
lionized	lionized
lionizes	lionizes
lionizing	lionizing
liquidize	liquidize
liquidized	liquidized
liquidizer	liquidizer
liquidizers	liquidizers
liquidizes	liquidizes
liquidizing	liquidizing
lit	lighted
litre	liter
litre 	 liter
litre 	 liter
litres 	 liters
localization	localization
localizational	localizational
localize	localize
localized	localized
localizes	localizes
localizing	localizing
louvre	louver
louvred	louvered
louvres	louvers
magnetize	magnetize
magnetized	magnetized
magnetizes	magnetizes
magnetizing	magnetizing
manoeuvrability	maneuverability
manoeuvrable	maneuverable
manoeuvre	maneuver
manoeuvred	maneuvered
manoeuvres	maneuvers
manoeuvring	maneuvering
manoeuvrings	maneuverings
marginalization	marginalization
marginalize	marginalize
marginalized	marginalized
marginalizes	marginalizes
marginalizing	marginalizing
marshalled	marshaled
marshalling	marshaling
marvelled	marveled
marvelling	marveling
marvellous	marvelous
marvellously	marvelously
materialization	materialization
materialize	materialize
materialized	materialized
materializes	materializes
materializing	materializing
maths	math
maximization	maximization
maximize	maximize
maximized	maximized
maximizes	maximizes
maximizing	maximizing
meagre	meager
mechanization	mechanization
mechanize	mechanize
mechanized	mechanized
mechanizes	mechanizes
mechanizing	mechanizing
mediaeval	medieval
memorialize	memorialize
memorialized	memorialized
memorializes	memorializes
memorializing	memorializing
memorize	memorize
memorized	memorized
memorizes	memorizes
memorizing	memorizing
mesmerize	mesmerize
mesmerized	mesmerized
mesmerizes	mesmerizes
mesmerizing	mesmerizing
metabolize	metabolize
metabolized	metabolized
metabolizes	metabolizes
metabolizing	metabolizing
metre	 meter
metres	 meters
micrometre	micrometer
micrometres	micrometers
militarize	militarize
militarized	militarized
militarizes	militarizes
militarizing	militarizing
milligramme	milligram
milligrammes	milligrams
millilitre	milliliter
millilitres	milliliters
millimetre	millimeter
millimetres	millimeters
miniaturization	miniaturization
miniaturize	miniaturize
miniaturized	miniaturized
miniaturizes	miniaturizes
miniaturizing	miniaturizing
minibuses	minibusses
minimize	minimize
minimized	minimized
minimizes	minimizes
minimizing	minimizing
misbehaviour	misbehavior
misdemeanour	misdemeanor
misdemeanours	misdemeanors
misspelt	misspelled
mitre	miter
mitres	miters
mobilization	mobilization
mobilize	mobilize
mobilized	mobilized
mobilizes	mobilizes
mobilizing	mobilizing
modelled	modeled
modeller	modeler
modellers	modelers
modelling	modeling
modernize	modernize
modernized	modernized
modernizes	modernizes
modernizing	modernizing
moisturize	moisturize
moisturized	moisturized
moisturizer	moisturizer
moisturizers	moisturizers
moisturizes	moisturizes
moisturizing	moisturizing
monologue	monolog
monologues	monologs
monopolization	monopolization
monopolize	monopolize
monopolized	monopolized
monopolizes	monopolizes
monopolizing	monopolizing
moralize	moralize
moralized	moralized
moralizes	moralizes
moralizing	moralizing
motorized	motorized
mould	mold
moulded	molded
moulder	molder
mouldered	moldered
mouldering	moldering
moulders	molders
mouldier	moldier
mouldiest	moldiest
moulding	molding
mouldings	moldings
moulds	molds
mouldy	moldy
moult	molt
moulted	molted
moulting	molting
moults	molts
moustache	mustache
moustached	mustached
moustaches	mustaches
moustachioed	mustachioed
multicoloured	multicolored
nanometre	nanometer
nationalization	nationalization
nationalizations	nationalizations
nationalize	nationalize
nationalized	nationalized
nationalizes	nationalizes
nationalizing	nationalizing
naturalization	naturalization
naturalize	naturalize
naturalized	naturalized
naturalizes	naturalizes
naturalizing	naturalizing
neighbour	neighbor
neighbourhood	neighborhood
neighbourhoods	neighborhoods
neighbouring	neighboring
neighbourliness	neighborliness
neighbourly	neighborly
neighbours	neighbors
neurone	neuron
neutralization	neutralization
neutralize	neutralize
neutralized	neutralized
neutralizes	neutralizes
neutralizing	neutralizing
newsagent	newsdealer
normalization	normalization
normalize	normalize
normalized	normalized
normalizes	normalizes
normalizing	normalizing
number plate	license plate
odour	odor
odourless	odorless
odours	odors
oenology	enology
oesophagus	esophagus
oesophaguses	esophaguses
oestrogen	estrogen
offence	offense
offences	offenses
omelette	omelet
omelettes	omelets
optimization	optimization
optimizational	optimizational
optimize	optimize
optimized	optimized
optimizes	optimizes
optimizing	optimizing
orch	flashlight
organization	organization
organizational	organizational
organizations	organizations
organize	organize
organized	organized
organizer	organizer
organizers	organizers
organizes	organizes
organizing	organizing
orthopaedic	orthopedic
orthopaedics	orthopedics
ostracize	ostracize
ostracized	ostracized
ostracizes	ostracizes
ostracizing	ostracizing
outmanoeuvre	outmaneuver
outmanoeuvred	outmaneuvered
outmanoeuvres	outmaneuvers
outmanoeuvring	outmaneuvering
overemphasize	overemphasize
overemphasized	overemphasized
overemphasizes	overemphasizes
overemphasizing	overemphasizing
oxidization	oxidization
oxidize	oxidize
oxidized	oxidized
oxidizes	oxidizes
oxidizing	oxidizing
paederast	pederast
paederasts	pederasts
paediatric	pediatric
paediatrician	pediatrician
paediatricians	pediatricians
paediatrics	pediatrics
paedophile	pedophile
paedophiles	pedophiles
paedophilia	pedophilia
palaeolithic	paleolithic
palaeontologist	paleontologist
palaeontologists	paleontologists
palaeontology	paleontology
panelled	paneled
panelling	paneling
panellist	panelist
panellists	panelists
paralyse	paralyze
paralysed	paralyzed
paralyses	paralyzes
paralysing	paralyzing
parcelled	parceled
parcelling	parceling
parlour	parlor
parlours	parlors
particularize	particularize
particularized	particularized
particularizes	particularizes
particularizing	particularizing
passivization	passivization
passivize	passivize
passivized	passivized
passivizes	passivizes
passivizing	passivizing
pasteurization	pasteurization
pasteurize	pasteurize
pasteurized	pasteurized
pasteurizes	pasteurizes
pasteurizing	pasteurizing
patronize	patronize
patronized	patronized
patronizes	patronizes
patronizing	patronizing
patronizingly	patronizingly
pavement	sidewalk
pedalled	pedaled
pedalling	pedaling
pedestrianization	pedestrianization
pedestrianize	pedestrianize
pedestrianized	pedestrianized
pedestrianizes	pedestrianizes
pedestrianizing	pedestrianizing
penalize	penalize
penalized	penalized
penalizes	penalizes
penalizing	penalizing
pencilled	penciled
pencilling	penciling
pernickety	persnickety
personalize	personalize
personalized	personalized
personalizes	personalizes
personalizing	personalizing
petrol	gasoline
pharmacopoeia	pharmacopeia
pharmacopoeias	pharmacopeias
pharmacy	drugstore
philosophize	philosophize
philosophized	philosophized
philosophizes	philosophizes
philosophizing	philosophizing
philtre	filter
philtres	filters
phoney	phony
picometre	picometer
plagiarize	plagiarize
plagiarized	plagiarized
plagiarizes	plagiarizes
plagiarizing	plagiarizing
plough	plow
ploughed	plowed
ploughing	plowing
ploughman	plowman
ploughmen	plowmen
ploughs	plows
ploughshare	plowshare
ploughshares	plowshares
polarization	polarization
polarize	polarize
polarized	polarized
polarizes	polarizes
polarizing	polarizing
politicization	politicization
politicize	politicize
politicized	politicized
politicizes	politicizes
politicizing	politicizing
popularization	popularization
popularize	popularize
popularized	popularized
popularizes	popularizes
popularizing	popularizing
postman	mailman
pouffe	pouf
pouffes	poufs
practize	practice
practized	practiced
practizes	practices
practizing	practicing
praesidium	presidium
praesidiums	presidiums
premi√®re	premiere
pressurization	pressurization
pressurize	pressurize
pressurized	pressurized
pressurizes	pressurizes
pressurizing	pressurizing
pretence	pretense
pretences	pretenses
primaeval	primeval
prioritization	prioritization
prioritize	prioritize
prioritized	prioritized
prioritizes	prioritizes
prioritizing	prioritizing
privatization	privatization
privatizations	privatizations
privatize	privatize
privatized	privatized
privatizes	privatizes
privatizing	privatizing
professionalization	professionalization
professionalize	professionalize
professionalized	professionalized
professionalizes	professionalizes
professionalizing	professionalizing
programme	program
programmes	programs
prologue	prolog
prologues	prologs
propagandize	propagandize
propagandized	propagandized
propagandizes	propagandizes
propagandizing	propagandizing
proselytize	proselytize
proselytized	proselytized
proselytizer	proselytizer
proselytizers	proselytizers
proselytizes	proselytizes
proselytizing	proselytizing
psychoanalyse	psychoanalyze
psychoanalysed	psychoanalyzed
psychoanalyses	psychoanalyzes
psychoanalysing	psychoanalyzing
publicize	publicize
publicized	publicized
publicizes	publicizes
publicizing	publicizing
pulverization	pulverization
pulverize	pulverize
pulverized	pulverized
pulverizes	pulverizes
pulverizing	pulverizing
pummelled	pummel
pummelling	pummeled
pyjama	pajama
pyjamas	pajamas
pzazz	pizzazz
quarrelled	quarreled
quarrelling	quarreling
quarter	fourth
quin	quint
radicalize	radicalize
radicalized	radicalized
radicalizes	radicalizes
radicalizing	radicalizing
railway	railroad
rancour	rancor
randomization	randomization
randomize	randomize
randomized	randomized
randomizes	randomizes
randomizing	randomizing
rationalization	rationalization
rationalizations	rationalizations
rationalize	rationalize
rationalized	rationalized
rationalizes	rationalizes
rationalizing	rationalizing
ravelled	raveled
ravelling	raveling
realizable	realizable
realization	realization
realizations	realizations
realize	realize
realized	realized
realizes	realizes
realizing	realizing
recognizable	recognizable
recognisably	recognizably
recognisance	recognizance
recognize	recognize
recognized	recognized
recognizes	recognizes
recognizing	recognizing
reconnoitre	reconnoiter
reconnoitred	reconnoitered
reconnoitres	reconnoiters
reconnoitring	reconnoitering
refuelled	refueled
refuelling	refueling
regularization	regularization
regularize	regularize
regularized	regularized
regularizes	regularizes
regularizing	regularizing
reinitialize	reinitialize
reinitialized	reinitialized
reinitializing	reinitializing
remodelled	remodeled
remodelling	remodeling
remould	remold
remoulded	remolded
remoulding	remolding
remoulds	remolds
reorganization	reorganization
reorganizations	reorganizations
reorganize	reorganize
reorganized	reorganized
reorganizes	reorganizes
reorganizing	reorganizing
revelled	reveled
reveller	reveler
revellers	revelers
revelling	reveling
revitalize	revitalize
revitalized	revitalized
revitalizes	revitalizes
revitalizing	revitalizing
revolutionize	revolutionize
revolutionized	revolutionized
revolutionizes	revolutionizes
revolutionizing	revolutionizing
rhapsodize	rhapsodize
rhapsodized	rhapsodized
rhapsodizes	rhapsodizes
rhapsodizing	rhapsodizing
rigour	rigor
rigours	rigors
ritualized	ritualized
rivalled	rivaled
rivalling	rivaling
romanticize	romanticize
romanticized	romanticized
romanticizes	romanticizes
romanticizing	romanticizing
rubbish	garbage
rumour	rumor
rumoured	rumored
rumours	rumors
sabre	saber
sabres	sabers
sailing boat	sailboat
saltpetre	saltpeter
sanatorium	sanitarium
sanitize	sanitize
sanitized	sanitized
sanitizes	sanitizes
sanitizing	sanitizing
satirize	satirize
satirized	satirized
satirizes	satirizes
satirizing	satirizing
saviour	savior
saviours	saviors
savour	savor
savoured	savored
savouries	savories
savouring	savoring
savours	savors
savoury	savory
scallywag	scalawag
scandalize	scandalize
scandalized	scandalized
scandalizes	scandalizes
scandalizing	scandalizing
sceptic	skeptic
sceptical	skeptical
sceptically	skeptically
scepticism	skepticism
sceptics	skeptics
sceptre	scepter
sceptres	scepters
scrutinize	scrutinize
scrutinized	scrutinized
scrutinizes	scrutinizes
scrutinizing	scrutinizing
secularization	secularization
secularize	secularize
secularized	secularized
secularizes	secularizes
secularizing	secularizing
sensationalize	sensationalize
sensationalized	sensationalized
sensationalizes	sensationalizes
sensationalizing	sensationalizing
sensitize	sensitize
sensitized	sensitized
sensitizes	sensitizes
sensitizing	sensitizing
sentimentalize	sentimentalize
sentimentalized	sentimentalized
sentimentalizes	sentimentalizes
sentimentalizing	sentimentalizing
sepulchre	sepulcher
sepulchres	sepulchers
serialization	serialization
serializational	serializational
serializations	serializations
serialize	serialize
serialized	serialized
serializes	serializes
serializing	serializing
sermonize	sermonize
sermonized	sermonized
sermonizes	sermonizes
sermonizing	sermonizing
sheikh	sheik
shovelled	shoveled
shovelling	shoveling
shrivelled	shriveled
shrivelling	shriveling
signalize	signalize
signalized	signalized
signalizes	signalizes
signalizing	signalizing
signalled	signaled
signalling	signaling
simultaneous	simultanous
skilful	skillful
skilfully	skillfully
sleigh	sled
smoulder	smolder
smouldered	smoldered
smouldering	smoldering
smoulders	smolders
snivelled	sniveled
snivelling	sniveling
snorkelled	snorkeled
snorkelling	snorkeling
snowplough	snowplow
snowploughs	snowplow
socialization	socialization
socialize	socialize
socialized	socialized
socializes	socializes
socializing	socializing
sodomize	sodomize
sodomized	sodomized
sodomizes	sodomizes
sodomizing	sodomizing
solemnize	solemnize
solemnized	solemnized
solemnizes	solemnizes
solemnizing	solemnizing
sombre	somber
specialization	specialization
specializational	specializational
specializations	specializations
specialize	specialize
specialized	specialized
specializes	specializes
specializing	specializing
speciality	specialty
spectre	specter
spectres	specters
spelt	spelled
spilt	spilled
spiralled	spiraled
spiralling	spiraling
splendour	splendor
splendours	splendors
spoilt	spoiled
squirrelled	squirreled
squirrelling	squirreling
stabilization	stabilization
stabilize	stabilize
stabilized	stabilized
stabilizer	stabilizer
stabilizers	stabilizers
stabilizes	stabilizes
stabilizing	stabilizing
standardization	standardization
standardize	standardize
standardized	standardized
standardizes	standardizes
standardizing	standardizing
stencilled	stenciled
stencilling	stenciling
sterilization	sterilization
sterilizations	sterilizations
sterilize	sterilize
sterilized	sterilized
sterilizer	sterilizer
sterilizers	sterilizers
sterilizes	sterilizes
sterilizing	sterilizing
stigmatization	stigmatization
stigmatize	stigmatize
stigmatized	stigmatized
stigmatizes	stigmatizes
stigmatizing	stigmatizing
storey	 story
storeys	 stories
subsidization	subsidization
subsidize	subsidize
subsidized	subsidized
subsidizer	subsidizer
subsidizers	subsidizers
subsidizes	subsidizes
subsidizing	subsidizing
succour	succor
succoured	succored
succouring	succoring
succours	succors
sulphate	sulfate
sulphates	sulfates
sulphide	sulfide
sulphides	sulfides
sulphur	sulfur
sulphurous	sulfurous
summarization	summarization
summarizational	summarizational
summarize	summarize
summarized	summarized
summarizes	summarizes
summarizing	summarizing
surname	last name
swivelled	swiveled
swivelling	swiveling
symbolization	symbolization
symbolizational	symbolizational
symbolize	symbolize
symbolized	symbolized
symbolizes	symbolizes
symbolizing	symbolizing
sympathize	sympathize
sympathized	sympathized
sympathizer	sympathizer
sympathizers	sympathizers
sympathizes	sympathizes
sympathizing	sympathizing
synchronization	synchronization
synchronizational	synchronizational
synchronize	synchronize
synchronized	synchronized
synchronizes	synchronizes
synchronizing	synchronizing
synthesize	synthesize
synthesized	synthesized
synthesizer	synthesizer
synthesizers	synthesizers
synthesizes	synthesizes
synthesizing	synthesizing
syphon	siphon
syphoned	siphoned
syphoning	siphoning
syphons	siphons
systematization	systematization
systematize	systematize
systematized	systematized
systematizes	systematizes
systematizing	systematizing
tantalize	tantalize
tantalized	tantalized
tantalizes	tantalizes
tantalizing	tantalizing
tantalizingly	tantalizingly
tasselled	tasseled
tea towel	dishtowel
technicolour	technicolor
templatization	templatization
templatizational	templatizational
templatize	templatize
templatized	templatized
templatizing	templatizing
temporize	temporize
temporized	temporized
temporizes	temporizes
temporizing	temporizing
tenderize	tenderize
tenderized	tenderized
tenderizes	tenderizes
tenderizing	tenderizing
terrorize	terrorize
terrorized	terrorized
terrorizes	terrorizes
terrorizing	terrorizing
theatre	theater
theatregoer	theatergoer
theatregoers	theatergoers
theatres	theaters
theorize	theorize
theorized	theorized
theorizes	theorizes
theorizing	theorizing
tickbox	checkbox
tights	pantyhose
titbit	tidbit
toffee	taffy
totalled	totaled
totaller	totaler
totalling	totaling
towelled	toweled
towelling	toweling
toxaemia	toxemia
tram	streetcar
tranquillize	tranquilize
tranquillized	tranquilized
tranquillizer	tranquilizer
tranquillizers	tranquilizers
tranquillizes	tranquilizes
tranquillizing	tranquilizing
tranquillity	tranquility
tranquillize	tranquilize
tranquillized	tranquilized
tranquillizer	tranquilizer
tranquillizers	tranquilizers
tranquillizes	tranquilizes
tranquillizing	tranquilizing
tranquilly	tranquility
transistorized	transistorized
transport	transportation
traumatize	traumatize
traumatized	traumatized
traumatizes	traumatizes
traumatizing	traumatizing
travelled	traveled
traveller	traveler
travellers	travelers
travelling	traveling
travelogue	travelog
travelogues	travelogs
trialled	trialed
trialling	trialing
tricolour	tricolor
tricolours	tricolors
trivialize	trivialize
trivialized	trivialized
trivializes	trivializes
trivializing	trivializing
tumour	tumor
tumours	tumors
tunnelled	tunneled
tunnelling	tunneling
tyrannize	tyrannize
tyrannized	tyrannized
tyrannizes	tyrannizes
tyrannizing	tyrannizing
tyre	 tire
tyres	 tires
unauthorized	unauthorized
uncategorized	uncategorized
uncivilized	uncivilized
underutilized	underutilized
unequalled	unequaled
unfavourable	unfavorable
unfavourably	unfavorably
unfeasible	infeasible
uninitialization	uninitialization
uninitializational	uninitializational
uninitialize	uninitialize
uninitialized	uninitialized
uninitializing	uninitializing
unionization	unionization
unionize	unionize
unionized	unionized
unionizes	unionizes
unionizing	unionizing
unorganized	unorganized
unravelled	unraveled
unravelling	unraveling
unrecognizable	unrecognizable
unrecognized	unrecognized
unrivalled	unrivaled
unsavoury	unsavory
untrammelled	untrammeled
upmarket	upscale
urbanization	urbanization
urbanize	urbanize
urbanized	urbanized
urbanizes	urbanizes
urbanizing	urbanizing
usable	useable
utilizable	utilizable
utilization	utilization
utilize	utilize
utilized	utilized
utilizes	utilizes
utilizing	utilizing
valour	valor
vandalize	vandalize
vandalized	vandalized
vandalizes	vandalizes
vandalizing	vandalizing
vaporization	vaporization
vaporize	vaporize
vaporized	vaporized
vaporizes	vaporizes
vaporizing	vaporizing
vapour	vapor
vapours	vapors
vectorizational	vectorizational
vectorize	vectorize
vectorized	vectorized
vectorizer	vectorizer
vectorizing	vectorizing
vectorization	vectorisation
verbalize	verbalize
verbalized	verbalized
verbalizes	verbalizes
verbalizing	verbalizing
vice	vise
victimization	victimization
victimize	victimize
victimized	victimized
victimizes	victimizes
victimizing	victimizing
videodisc	videodisk
videodiscs	videodisks
vigour	vigor
virtualization	virtualization
virtualize	virtualize
virtualized	virtualized
virtualizing	virtualizing
visualization	visualization
visualizations	visualizations
visualize	visualize
visualized	visualized
visualizes	visualizes
visualizing	visualizing
vocalization	vocalization
vocalizations	vocalizations
vocalize	vocalize
vocalized	vocalized
vocalizes	vocalizes
vocalizing	vocalizing
vulcanized	vulcanized
vulgarization	vulgarization
vulgarize	vulgarize
vulgarized	vulgarized
vulgarizes	vulgarizes
vulgarizing	vulgarizing
waggon	wagon
waggons	wagons
watercolour	watercolor
watercolours	watercolors
weaselled	weaseled
weaselling	weaseling
westernization	westernization
westernize	westernize
westernized	westernized
westernizes	westernizes
westernizing	westernizing
wilful	willful
wilfully	willfully
windscreen	windshield
womanize	womanize
womanized	womanized
womanizer	womanizer
womanizers	womanizers
womanizes	womanizes
womanizing	womanizing
woollen	woolen
woollens	woolens
woollies	woolies
woolly	wooly
worshipped	worshiped
worshipper	worshiper
worshipping	worshiping
yodelled	yodeled
yodelling	yodeling
yoghourt	yogurt
yoghourts	yogurts
yoghurt	yogurt
yoghurts	yogurts
